t,x,y,fh,fv,r,s,frame:
0,-156,70,1,0,29,18,0
1,-156,69,1,0,29,18,0
2,-152,73,1,0,29,18,0
3,-146,79,1,0,29,18,0
4,-139,89,1,0,29,18,0
5,-139,95,1,0,29,18,0
6,-139,97,1,0,29,18,0
7,-145,102,1,0,29,18,0
8,-151,105,1,0,29,18,0
9,-163,109,1,0,29,18,0
10,-169,109,1,0,29,18,0
11,-171,108,1,0,29,18,0
12,-176,98,1,0,29,18,0
13,-181,81,1,0,29,18,0
14,-181,73,1,0,29,18,0
15,-181,72,1,0,29,18,0
16,-181,72,1,0,29,18,0
17,-181,74,1,0,29,18,0
18,-180,80,1,0,29,18,0
19,-179,89,1,0,29,18,0
20,-179,98,1,0,29,18,0
21,-179,106,1,0,29,18,0
22,-179,112,1,0,29,18,0
23,-179,112,1,0,29,18,0
24,-179,112,1,0,29,18,0
25,-177,108,1,0,29,18,0
26,-173,98,1,0,29,18,0
27,-169,85,1,0,29,18,0
28,-166,75,1,0,29,18,0
29,-165,72,1,0,29,18,0
30,-165,74,1,0,29,18,0
31,-167,89,1,0,29,18,0
32,-171,107,1,0,29,18,0
33,-180,131,1,0,29,18,0
34,-186,142,1,0,29,18,0
35,-188,146,1,0,29,18,0
36,-188,146,1,0,29,18,0
37,-182,137,1,0,29,18,0
38,-174,125,1,0,29,18,0
39,-164,109,1,0,29,18,0
40,-159,90,1,0,29,18,0
41,-156,78,1,0,29,18,0
42,-156,70,1,0,29,18,0
43,-156,70,1,0,29,18,0
44,-156,71,1,0,29,18,0
45,-156,80,1,0,29,18,0
46,-156,86,1,0,29,18,0
47,-156,95,1,0,29,18,0
48,-157,95,1,0,29,18,0
49,-157,95,1,0,29,18,0
50,-157,92,1,0,29,18,0
51,-158,82,1,0,29,18,0
52,-158,72,1,0,29,18,0
53,-158,67,1,0,29,18,0
54,-158,66,1,0,29,18,0
55,-158,66,1,0,29,18,0
56,-159,68,1,0,29,18,0
57,-160,77,1,0,29,18,0
58,-162,87,1,0,29,18,0
59,-163,94,1,0,29,18,0
60,-163,95,1,0,29,18,0
61,-164,95,1,0,29,18,0
62,-165,89,1,0,29,18,0
63,-165,78,1,0,29,18,0
64,-165,68,1,0,29,18,0
65,-163,57,1,0,29,18,0
66,-161,44,1,0,29,18,0
67,-161,43,1,0,29,18,0
68,-161,43,1,0,29,18,0
69,-161,49,1,0,29,18,0
70,-161,65,1,0,29,18,0
71,-161,80,1,0,29,18,0
72,-161,92,1,0,29,18,0
73,-161,96,1,0,29,18,0
74,-161,94,1,0,29,18,0
75,-161,86,1,0,29,18,0
76,-159,67,1,0,29,18,0
77,-158,46,1,0,29,18,0
78,-158,23,1,0,29,18,0
79,-158,11,1,0,29,18,0
80,-158,11,1,0,29,18,0
81,-158,11,1,0,29,18,0
82,-159,22,1,0,29,18,0
83,-159,36,1,0,29,18,0
84,-160,49,1,0,29,18,0
85,-162,63,1,0,29,18,0
86,-163,64,1,0,29,18,0
87,-163,64,1,0,29,18,0
88,-163,64,1,0,29,18,0
89,-161,58,1,0,29,18,0
90,-160,48,1,0,29,18,0
91,-159,44,1,0,29,18,0
92,-157,33,1,0,29,18,0
93,-157,33,1,0,29,18,0
94,-157,34,1,0,29,18,0
95,-158,50,1,0,29,18,0
96,-160,68,1,0,29,18,0
97,-161,92,1,0,29,18,0
98,-164,108,1,0,29,18,0
99,-167,115,1,0,29,18,0
100,-168,115,1,0,29,18,0
101,-170,112,1,0,29,18,0
102,-175,105,1,0,29,18,0
103,-179,98,1,0,29,18,0
104,-183,89,1,0,29,18,0
105,-189,78,1,0,29,18,0
106,-192,72,1,0,29,18,0
107,-192,72,1,0,29,18,0
108,-192,72,1,0,29,18,0
109,-190,75,1,0,29,18,0
110,-185,79,1,0,29,18,0
111,-168,86,1,0,29,18,0
112,-159,92,1,0,29,18,0
113,-148,97,1,0,29,18,0
114,-136,103,1,0,29,18,0
115,-128,107,1,0,29,18,0
116,-119,108,1,0,29,18,0
117,-116,108,1,0,29,18,0
118,-111,104,1,0,29,18,0
119,-109,97,1,0,29,18,0
120,-107,88,1,0,29,18,0
121,-105,76,1,0,29,18,0
122,-105,62,1,0,29,18,0
123,-106,54,1,0,29,18,0
124,-110,49,1,0,29,18,0
125,-113,49,1,0,29,18,0
126,-116,49,1,0,29,18,0
127,-120,52,1,0,29,18,0
128,-127,58,1,0,29,18,0
129,-133,65,1,0,29,18,0
130,-142,73,1,0,29,18,0
131,-150,86,1,0,29,18,0
132,-157,98,1,0,29,18,0
133,-160,103,1,0,29,18,0
134,-164,105,1,0,29,18,0
135,-166,106,1,0,29,18,0
136,-171,106,1,0,29,18,0
137,-176,102,1,0,29,18,0
138,-180,95,1,0,29,18,0
139,-182,86,1,0,29,18,0
140,-182,76,1,0,29,18,0
141,-181,70,1,0,29,18,0
142,-180,69,1,0,29,18,0
143,-179,69,1,0,29,18,0
144,-175,73,1,0,29,18,0
145,-170,79,1,0,29,18,0
146,-161,86,1,0,29,18,0
147,-150,92,1,0,29,18,0
148,-137,95,1,0,29,18,0
149,-128,97,1,0,29,18,0
150,-124,93,1,0,29,18,0
151,-122,87,1,0,29,18,0
152,-122,80,1,0,29,18,0
153,-122,73,1,0,29,18,0
154,-122,67,1,0,29,18,0
155,-126,60,1,0,29,18,0
156,-127,59,1,0,29,18,0
157,-129,59,1,0,29,18,0
158,-132,62,1,0,29,18,0
159,-135,69,1,0,29,18,0
160,-140,79,1,0,29,18,0
161,-145,87,1,0,29,18,0
162,-153,97,1,0,29,18,0
163,-156,104,1,0,29,18,0
164,-157,105,1,0,29,18,0
165,-157,105,1,0,29,18,0
166,-157,105,1,0,29,18,0
167,-158,103,1,0,29,18,0
168,-159,97,1,0,29,18,0
169,-161,90,1,0,29,18,0
170,-161,83,1,0,29,18,0
171,-161,74,1,0,29,18,0
172,-161,73,1,0,29,18,0
173,-160,73,1,0,29,18,0
174,-158,76,1,0,29,18,0
175,-154,82,1,0,29,18,0
176,-149,87,1,0,29,18,0
177,-145,92,1,0,29,18,0
178,-141,96,1,0,29,18,0
179,-140,96,1,0,29,18,0
180,-140,96,1,0,29,18,0
181,-140,94,1,0,29,18,0
182,-140,88,1,0,29,18,0
183,-140,81,1,0,29,18,0
184,-140,76,1,0,29,18,0
185,-140,76,1,0,29,18,0
186,-140,76,1,0,29,18,0
187,-140,78,1,0,29,18,0
188,-140,87,1,0,29,18,0
189,-142,98,1,0,29,18,0
190,-143,100,1,0,29,18,0
191,-143,100,1,0,29,18,0
192,-143,100,1,0,29,18,0
193,-143,100,1,0,29,18,0
194,-144,98,1,0,29,18,0
195,-145,95,1,0,29,18,0
196,-147,92,1,0,29,18,0
197,-148,90,1,0,29,18,0
198,-149,88,1,0,29,18,0
199,-149,88,1,0,29,18,0
200,-149,88,1,0,29,18,0
201,-149,88,1,0,29,18,0
202,-149,88,1,0,29,18,0
203,-149,88,1,0,29,18,0
204,-149,88,1,0,29,18,0
205,-149,88,1,0,29,18,0
206,-149,88,1,0,29,18,0
207,-149,88,1,0,29,18,0
208,-149,88,1,0,29,18,0
209,-149,88,1,0,29,18,0
210,-149,88,1,0,29,18,0
211,-149,88,1,0,29,18,0
212,-149,88,1,0,29,18,0
213,-149,88,1,0,29,18,0
214,-149,88,1,0,29,18,0
